00000000000011000000000000
01111011111011011111011110
01111011111011011111011110
01111011111011011111011110
30000000000000000000000003
01111011011111111011011110
01111011011111111011011110
00000011000011000011000000
11111011111011011111011111
11111011111011011111011111
11111012222222222221011111
11111012111122111121011111
00000022122222222122000000
11111012111111111121011111
11111012222222222221011111
11111012111111111121011111
30000000000011000000000003
01111011111011011111011110
01111011111011011111011110
00011000000000000000011000
11011011011111111011011011
11011011011111111011011011
00000011000011000011000000
01111111111011011111111110
01111111111011011111111110
00000000000000000000000000
