00000000000000000000000000
01111111111011011111111110
01111111111011011111111110
01111111111011011111111110
00000000000000000000000000
01111011011111111011011110
01111011011111111011011110
00000011000011000011000000
11111011111011011111011111
11111011111011011111011111
11111010000000000001011111
11111010111100111101011111
00000000100000000100000000
00000000100000000100000000
11111010111100111101011111
11111010000000000001011111
11111011111011011111011111
11111011111011011111011111
00000011000011000011000000
01111011011111111011011110
01111011011111111011011110
00000000000000000000000000
01111111111011011111111110
01111111111011011111111110
01111111111011011111111110
00000000000000000000000000
