10000100000000100001
10110101100110101101
10100000100100000101
10101101100110110101
10000000000010100001
10100001111110100101
10100001000010100101
10100001011110100101
10100000000000100101
10110101111110101101
10000100000000100001
10100001000010100101
10100001011110100101
10100000000000100101
10110101111110101101
10000100000000100001
10000100000000100001
10110101100110101101
10100000100100000101
10100000100100000101